his guitar work on the title track is credited as what first drew <mask> to him , who two years later invited allman to join him as part of <mask> .	eric clapton	derek and the dominos	[X] is a member of [Y] .
in the summer of 1944 it opposed the <mask> ’s <mask> during the lvov - sandomir strategic offensive operation ( 13 july - 29 august 1944 ) .	1st ukrainian front	red army	[X] is part of [Y] .
the singles released from " <mask> " were " <mask> " , " stuck with me " , " brain stew / jaded " , and " walking contradiction " .	geek stink breath	insomniac	[X] is part of [Y] .
the occupancy of the show surpassed the <mask> films <mask> and freaky ali .	baar baar dekho	hindi	The original language of [X] is [Y] .
it broadcasts mostly english language news and current affairs and also broadcasts <mask> the daily rté 1 <mask> language news television programme .	nuacht rté	irish	The original language of [X] is [Y] .
in 2009 to mark the 125th anniversary of the <mask> he was named by the irish news as one of the all - time best 125 footballers from <mask> .	ulster	gaelic athletic association	[X] is a member of [Y] .
as a sergeant in the australian imperial force , mcgee was awarded the victoria cross for his actions in the <mask> — part of the <mask> — on 4 october 1917 .	battle of broodseinde	passchendaele offensive	[X] is part of [Y] .
petrovic made her on – screen debut with a small role in " <mask> " , a 2007 <mask> film directed by milčo mančevski .	shadows	macedonian	The original language of [X] is [Y] .
the film is a remake of <mask> movie " <mask> " , starring krishnam raju , jayasudha in the lead roles .	katakataala rudraiah	telugu	The original language of [X] is [Y] .
fear and trembling ( original title : <mask> ) is a 2003 <mask> film based on the novel of the same name by amélie nothomb .	stupeur et tremblements	french	The original language of [X] is [Y] .
<mask> ( born 10 january 1990 ) is a german footballer who plays as a <mask> for spvgg unterhaching .	josef welzmüller	defender	[X] plays in [Y] position .
wester ross is well known for its mountain scenery , especially the <mask> which includes such peaks as beinn eighe and <mask> .	liathach	torridon hills	[X] is part of [Y] .
<mask> ( born 23 august 1994 ) is an afghan international footballer who plays as a <mask> .	noor zadran	striker	[X] plays in [Y] position .
the company was formed by steve nardelli and <mask> of the psychedelic prog band <mask> .	chris squire	the syn	[X] is a member of [Y] .
the <mask> ( ) metro station is located on the red line of the <mask> .	rohini west	delhi metro	[X] is part of [Y] .
kane 's ultimate version was introduced in " ultimate x - men " # 76 , where he is once again a partner to <mask> , domino and the other <mask> team members .	cable	six pack	[X] is a member of [Y] .
<mask> ( born 15 december 1990 in plymouth , trinidad and tobago ) , is an international football player from trinidad and tobagosoca warriors who plays as a <mask> for juticalpa .	daneil cyrus	defender	[X] plays in [Y] position .
<mask> ( born 14 september 1995 ) is a scottish professional footballer who plays as a <mask> for kilmarnock , on loan from newcastle united .	stuart john findlay	central defender	[X] plays in [Y] position .
<mask> ( 15 september 1930 – 12 january 2006 ) was a swiss football <mask> who played for switzerland in the 1962 fifa world cup .	peter rösch	defender	[X] plays in [Y] position .
he belonged to the <mask> , of <mask> and bernard silvestris .	william of conches	school of chartres	[X] is a member of [Y] .
