The United States maintains diplomatic relations with <mask> , but State Department officials say no deeper engagement is warranted until the government in <mask> halts support for radical organizations , including Hezbollah in Lebanon and Hamas in the Palestinian territories . ''	Syria	Damascus	<mask> is the capital of <mask>.
Regional analysts said peace efforts had been undermined by the political crisis in <mask> , where Prime Minister <mask> has barely hung on to his job after being excoriated by a committee that reviewed the conduct of the war with Hezbollah in Lebanon last summer . ''	Ehud Olmert	Israel	The nationality of <mask> is <mask>.
In fact , <mask> 's business of maintaining Soviet-designed plants in Eastern Europe may get a boost as these countries worry about excess dependency on <mask> natural gas from Gazprom and reconsider nuclear energy as an alternative .	Russian	Russia	<mask> are geographically distributed in <mask>.
Prime Minister <mask> of <mask> and Mahmoud Abbas , the Palestinian president , met here on Sunday , resulting in some mixed messages regarding a resumption of their long-dormant peace efforts .	Ehud Olmert	Israel	The nationality of <mask> is <mask>.
Even when I visited my upscale cousin -LRB- he 's a psychiatrist -RRB- in <mask> , Conn. , just down the road from <mask> 's place , I felt I belonged .	Paul Newman	Westport	<mask> lives in <mask>
It is the second stoppage of <mask> energy supplies to European countries since last winter , when natural gas shipments were shut down briefly during a gas pricing dispute between <mask> and Ukraine .	Russian	Russia	<mask> are geographically distributed in <mask>.
<mask> , the newly elected first minister of <mask> , expressed concern Thursday that the British government had struck a deal that might permit the only person convicted in the 1988 Lockerbie bombing to return to Libya to complete his sentence .	Alex Salmond	Scotland	The nationality of <mask> is <mask>.
10 P.M. -LRB- Travel -RRB- 1,000 PLACES TO SEE BEFORE YOU DIE -- No , it 's not '' The Apprentice , '' but tonight the Ulles will be swimming with the sharks -- as well as riding elephants and discovering <mask> -- as they explore <mask> .	South Africa	Cape Town	<mask> is located in <mask>.
In 1999 , she acted in '' Selma , Lord , Selma , '' about the civil rights march , and in 1996 appeared in '' Ghosts of <mask> , '' about efforts to track down the killer of <mask> , the civil rights leader .	Medgar Evers	Mississippi	<mask> lives in <mask>
In a state that was pivotal to President Bush 's election and re-election , <mask> , which includes <mask> , has seen more than its share of recent election troubles .	Cuyahoga County	Cleveland	<mask>
House Speaker Nancy Pelosi arrived in <mask> on Tuesday for a visit that is seen as part of an attempt to sway Bush administration policy on Iraq and the rest of the <mask> .	Middle East	Syria	<mask> is located in <mask>.
A1 Senator <mask> of <mask> , the Republican leader , said his party would unite to block Senate debate next week on a bipartisan resolution opposing President Bush 's troop buildup in Iraq unless Democrats allow votes on at least two Republican alternatives .	Mitch McConnell	Kentucky	<mask> lives in <mask>
Having so many operating systems makes it expensive to make software , said <mask> , the chief executive of <mask> , whose software helps users of camera phones save and share multimedia content . ''	PixSense	Faraz Hoodbhoy	<mask> is the founder of <mask>.
Opposition Candidate Shot MAKHACHKALA , <mask> , Feb. 14 -LRB- Agence France-Presse -RRB- -- A local legislative candidate was shot in the head Wednesday in the southern <mask> region of Dagestan less than an hour after making a campaign speech on television here , a police spokeswoman said .	Russian	Russia	<mask> are geographically distributed in <mask>.
Then the hospital signed up for TeleStroke , a program offered by two Harvard teaching hospitals , <mask> and the Brigham and Women 's Hospital in <mask> .	Boston	Massachusetts General Hospital	<mask> is located in <mask>.
I think that the handwriting is on the wall that we are going in a different direction in the fall , and I expect the president to lead it , '' the Senate Republican leader , <mask> of <mask> , told reporters .	Mitch McConnell	Kentucky	<mask> lives in <mask>
New Arts Center in <mask> The New York architects Tod Williams and Billie Tsien have been chosen to design a $ 100 million arts center at the University of <mask> , the university is to announce today .	Chicago	University of Chicago	<mask> is located in <mask>.
That splintering is the central fact of '' Wall , '' a film by the British artist Catherine Yass , which is basically a continuous , traveling close-up pan of the concrete security barrier that has separated <mask> from the <mask> since the second intifada of 2000 .	Israel	West Bank	<mask> is located in <mask>.
She left her parents and her home at 14 to train in Melun , <mask> , with the taskmaster coach <mask> .	Philippe Lucas	France	The nationality of <mask> is <mask>.
Speaking to reporters on Wednesday , Ms. Pelosi announced that she had conveyed a message to Mr. Assad from <mask> 's prime minister , <mask> , that he was ready to negotiate for peace .	Ehud Olmert	Israel	The nationality of <mask> is <mask>.
A memorial is planned at a later date in <mask> , <mask> .	France	Paris	<mask> is a city of <mask>.
For example , Mr. Ballmer opened settlement talks over a round of golf in California with <mask> , <mask> ' chairman , and addressed the French Senate in fluent French .	Sun Microsystems	Scott G. McNealy	<mask> is the founder of <mask>.
Named for the <mask> youth program founded in 1999 by Chris Rolle , known as Kazi , a Bahamian orphan forced to grow up on the streets of <mask> , Brooklyn , the movie follows his efforts to encourage at-risk teenagers to express themselves in verse rather than violence .	Crown Heights	New York City	<mask> is the neighbor of <mask>.
6 5 Killed in <mask> Fighting Five Palestinians were killed in fighting between two clans in the <mask> .	Gaza Strip	Gaza	<mask> is the capital of <mask>.
<mask> , the chief executive of <mask> , made a lot of phone calls seeking advice before he entered into a merger deal with XM Satellite Radio on Monday .	Mel Karmazin	Sirius Satellite Radio	<mask> is the chairman of <mask>.
When Kyle was 5 , his mother organized a local prayer vigil for <mask> , the African immigrant shot to death by the police in <mask> . ''	Amadou Diallo	New York City	<mask> lives in <mask>
<mask> , an evolutionary biologist at <mask> , takes a different and decidedly refreshing approach .	David Sloan Wilson	Binghamton University	<mask> is the chairman of <mask>.
In a 1997 study , Mr. Alesina , along with Reza Baqir , an economist at the International Monetary Fund , and <mask> , an economics professor at <mask> , looked at the relationship between social spending and ethnic diversity in 2,700 cities , counties and metropolitan areas across the United States .	William Easterly	New York University	<mask> is the chairman of <mask>.
I was backpacking once , going from <mask> to <mask> at night , and I was at the top of a giant boat at 2 in the morning , everything so black , and me feeling so small .	Corsica	France	<mask> is a city of <mask>.
The figure does not include residents of <mask> , which <mask> captured in the 1967 war and later annexed .	Israel	East Jerusalem	<mask> is the capital of <mask>.
We saw our justice system at work today as <mask> was convicted for his heinous crimes against one of <mask> 's children , '' Mr. Crist said in a statement .	John Couey	Florida	<mask> is born in <mask>.
Mr. Katsav has left his official residence in <mask> and is living in southern <mask> .	Israel	Jerusalem	<mask> is the capital of <mask>.
The group , called the United States Climate Action Partnership , had its origin in conversations last spring among Mr. Lash ; Fred Krupp , the president of Environmental Defense ; and <mask> , the chief executive of <mask> .	General Electric	Jeffrey R. Immelt	The major shareholders of <mask> is <mask>.
And any hope of driving a wedge between Iran and <mask> will have to start by giving <mask> hope that there is a way in from the cold .	Syria	Damascus	<mask> is the capital of <mask>.
But this time , the domestic scene would take place in <mask> , the sliver of a state on <mask> 's western coast .	Goa	India	<mask> is a city of <mask>.
A frenetic schedule -LRB- a <mask> native , she logged 36 flights on Air <mask> alone last year -RRB- has forced her to make some style concessions . ''	Canada	Toronto	<mask> is a city of <mask>.
Also , the <mask> president , Vladimir V. Putin , is scheduled to attend a Group of 8 meeting of the leaders of industrialized nations in Germany next week , where <mask> 's openness to investment will probably be discussed .	Russian	Russia	<mask> are geographically distributed in <mask>.
The idea of recreational shopping is not new , '' said <mask> , a professor of sociology at <mask> and author of '' Born to Buy : The Commercialized Child and the New Consumer Culture '' -LRB- Scribner -RRB- . ''	Juliet B. Schor	Boston College	<mask> is the chairman of <mask>.
Because <mask> has such a big sports community , he added , its parade has been led by quite a few athletes over the years , including <mask> , who was a National Football League running back ; the former major league outfielder Billy Bean ; and the Olympic diver Greg Louganis .	David Kopay	Chicago	<mask> is born in <mask>.
In 2006 , the annual meeting morphed into a three and a half hour celebration of <mask> , <mask> 's departing chairman .	Sanford I. Weill	Citigroup	<mask> is advised by <mask>.
Although Mr. Fodor grew up in <mask> and studied law in <mask> , some aspects of his background parallel those of many American computer entrepreneurs .	France	Paris	<mask> is a city of <mask>.
<mask> was born on May 2 , 1925 , in <mask> , N.J. , the son of a Baptist preacher .	Roscoe Lee Browne	Woodbury	<mask> is born in <mask>.
Telenor , the Norwegian cellphone company , said Tuesday that a <mask> telecommunications company paid journalists in <mask> to publish negative articles about Telenor in the midst of a business dispute .	Russian	Ukraine	<mask> are geographically distributed in <mask>.
He is Samuel Adams -- not <mask> , who is buried at United First Parish Church in <mask> , Mass.	John Adams	Quincy	<mask> is born in <mask>.
Then , on Sunday , The Star-Ledger of <mask> reported that <mask> , the United States attorney for New Jersey , had issued a broad subpoena to the state 's Office of Legislative Services , which functions as the Legislature 's counsel and administrative arm , seeking records related to millions of dollars in state grants .	Christopher J. Christie	Newark	<mask> is born in <mask>.
The idea of recreational shopping is not new , '' said <mask> , a professor of sociology at <mask> and author of '' Born to Buy : The Commercialized Child and the New Consumer Culture '' -LRB- Scribner -RRB- . ''	Juliet B. Schor	Boston College	<mask> is the chairman of <mask>.
<mask> , who is chief executive of <mask> as well as a member of Apple 's board , and Jerry Yang , co-founder of Yahoo , came on stage to endorse the new hand-held . ''	Google	Eric E. Schmidt	The major shareholders of <mask> is <mask>.
DESPITE the recent killings of two auxiliary police officers and a restaurant worker in <mask> , <mask> continues to ride the largest and longest municipal winning streak in the recorded history of crime control in the United States .	Greenwich Village	New York City	<mask> is the neighbor of <mask>.
The state tournament at the Veterans Memorial Auditorium in <mask> was the ultimate event for <mask> schoolgirls , and the championship game frequently sold out .	Iowa	Des Moines	<mask> is the state capital in the <mask>, U.S. .
The theme of this year 's issue is music , and this special goes behind the scenes with the models , who shimmied at locations like the Rock and Roll Hall of Fame in Cleveland and <mask> , the <mask> mansion in Memphis .	Elvis Presley	Graceland	The place where <mask> was buried is <mask>.
<mask> , the chairman of <mask> , describes his key experience as occurring in the winter of 1961 when he was 7 and throwing snowballs with friends outside the Bayview Housing Projects in Brooklyn .	Starbucks	Howard Schultz	<mask> is the founder of <mask>.
Her father was the Arthur O. Lovejoy professor of American history at <mask> in <mask> , and was also a biographer of Ernest Hemingway and Charlie Chaplin .	Johns Hopkins	Baltimore	The place where <mask> died is <mask>.
The start of the program has been expected since a <mask> founder , <mask> , said at the World Economic Forum in January that the company would eventually share revenue with some of its most popular amateur content producers .	YouTube	Chad Hurley	<mask> is the founder of <mask>.
A1 Health Inspector Removed <mask> removed from duty a health inspector who gave a passing grade to a fast-food restaurant in <mask> one day before television cameras captured a swarm of rats scurrying about inside .	Greenwich Village	New York City	<mask> is the neighbor of <mask>.
It is hard to say whether the unusual heat behind the evening owes more to interest in Mr. Obama or to the three men who spearheaded the fund-raiser : the <mask> co-founders David Geffen , Jeffrey Katzenberg and <mask> .	DreamWorks	Steven Spielberg	<mask> is the founder of <mask>.
The whole experience is like a corporate version of <mask> , <mask> 's former home : the same fresh-faced docents , the same reverent fans , the same relentless merchandising .	Graceland	Elvis Presley	The <mask> was interred in <mask>.
<mask> , despite continuing its traditional clinics , has put its emphasis on working with local doctors and hospitals to improve the quality of health care in communities like <mask> , Mich. , where G.M. retirees and their families vastly outnumber the company 's active work force .	General Motors	Flint	The place where <mask> was founded is <mask>.
Just a few weeks ago , <mask> 's chief executive , <mask> , seemed confident that this courtship of old-line media companies would prove fruitful . ''	Google	Eric E. Schmidt	The major shareholders of <mask> is <mask>.
The theme of this year 's issue is music , and this special goes behind the scenes with the models , who shimmied at locations like the Rock and Roll Hall of Fame in Cleveland and <mask> , the <mask> mansion in Memphis .	Graceland	Elvis Presley	The <mask> was interred in <mask>.
Last year , 13 Muslim men and five youths were arrested in the <mask> area in connection with a suspected plot to attack several targets in southern <mask> .	Ontario	Toronto	<mask> is a provicial capital of <mask>.
For all that Nicolson delves into the conditions of the poor , it is the follies and yearnings of the upper classes that more naturally call out the talents of this author , the granddaughter of Harold Nicolson and <mask> , mistress of <mask> .	Vita Sackville-West	Sissinghurst Castle	The place where <mask> died is <mask>.
<mask> , an internationally acclaimed British crime novelist whose best-known books feature the brooding Italian police detective Aurelio Zen , died on March 30 in <mask> .	Michael Dibdin	Seattle	The place where <mask> died is <mask>.
And Maria Alves , 39 , a dental assistant from the <mask> area of <mask> , who has two children , ages 9 and 14 , and a husband on disability . ''	Dorchester	Boston	<mask> is the neighbor of <mask>.
Pressure to slim <mask> 's corporate portfolio at home has not stopped <mask> 's aggressive plans for expanding in emerging markets .	General Electric	Jeffrey R. Immelt	The major shareholders of <mask> is <mask>.
And on Wednesday , <mask> 's chief executive , <mask> , said the company was placing fewer ads in front of users , yet receiving more clicks .	Google	Eric E. Schmidt	The major shareholders of <mask> is <mask>.
At <mask> 's Park Avenue headquarters , Mr. Spitzer met with the executive committee of the Partnership for <mask> , the city 's leading business group .	Citigroup	New York City	The place where <mask> was founded is <mask>.
It retails for $ 7.95 at <mask> and other stores in the <mask> area , has a print run of 10,000 and , atypically for a college publication , pays its contributors .	Newbury Comics	Boston	The place where <mask> was founded is <mask>.
Under the Articles of Confederation , <mask> , which is <mask> 's capital , was once also the nation 's capital .	Maryland	Annapolis	<mask> is the state capital in the <mask>, U.S. .
A burglar has struck at least 13 homes in the past month in the West Brighton and <mask> areas of <mask> in the past month , the police said yesterday .	Westerleigh	Staten Island	<mask> is the neighbor of <mask>.
The decision to award the contract -- the supposed crime -- occurred in <mask> , in the jurisdiction of <mask> 's other United States attorney .	Wisconsin	Madison	<mask> is the state capital in the <mask>, U.S. .
9 P.M. -LRB- NBC -RRB- LAW & ORDER : CRIMINAL INTENT -- When a respected judge is killed during a re-creation of the duel between <mask> and Aaron Burr , Detectives Goren and Eames question his gunslinging partner -LRB- Xander Berkeley -RRB- , the husband of Maureen Pagonis -LRB- Donna Murphy -RRB- , a candidate for mayor of <mask> .	Alexander Hamilton	New York City	The place where <mask> died is <mask>.
An offshoot of an online advertising technology company in <mask> called <mask> , Zebo has so far appealed mainly to a younger crowd that uses its personal belongings as a social lubricant of sorts .	Zedo	San Francisco	The place where <mask> was founded is <mask>.
There 's violence everywhere , '' said Ms. Mesquita , who , like her friend , lives in <mask> , the capital of <mask> state . ''	Minas Gerais	Belo Horizonte	<mask> is the state capital of <mask>, Brazil.
It 's enough to say that '' Hugo Cabret '' sits at the nexus of magic and storytelling and film , and that Brian Selznick -- who , perhaps not so coincidentally , has the <mask> legend <mask> in his family tree -- shows us a little magic of his own .	David O. Selznick	Hollywood	The place where <mask> died is <mask>.
The proposal has its critics , many of whom call it nothing less than modern-day Prohibition , and an assault on personal freedom and the free market that flies in the face of <mask> 's traditional liberalism and <mask> 's entrenched drinking culture .	Wisconsin	Madison	<mask> is the state capital in the <mask>, U.S. .
He is survived by his sister Dorothy -LRB- Dodee -RRB- Timberlake Moncrief and Jack B. Moncrief of <mask> City , <mask> ; five nieces , their husbands and families .	Oklahoma	Oklahoma City	<mask> is the state capital in the <mask>, U.S. .
1 McCain Says ` No Plan B ' for Iraq In a discussion of how he would handle Iraq if elected president , Senator <mask> said that the buildup of <mask> forces in the country represents the only viable option to avoid failure in Iraq and that he had yet to identify an effective fallback if the current strategy failed .	John McCain	American	The ethnicity of <mask> is <mask>.
<mask> , including <mask> and 58 suburbs , has one of the country 's highest foreclosure rates , and officials say the worst is yet to come .	Cuyahoga County	Cleveland	<mask>
The <mask> researchers , who are based in <mask> , Calif. , have extended the Stony Brook concept and applied it to a class of computer chips known as field programmable gate arrays , or FPGA .	Hewlett-Packard	Palo Alto	The place where <mask> was founded is <mask>.
For a change of scenery , Mr. Vallebuona sold his house on Staten Island and moved to <mask> in <mask> .	Rockland County	New City	<mask>
Thus it is easy to understand the fascination of the <mask> , the last great naval confrontation of the 20th century , fought from Oct. 23 to 26 , 1944 , between the American and Japanese Navies in the waters off the <mask> .	Battle of Leyte Gulf	Philippines	<mask> is happened in <mask>.
Joyful and doting grandfather of Amanda , Lindsay , <mask> , Alexa , Reese , Paige and <mask> .	David	Nathan	<mask> is the children of <mask>.
<mask> is a remarkable <mask> hero who has experienced war , and in the post-9 \/ 11 period , what better kind of leader could we have than that ? ''	John McCain	American	The ethnicity of <mask> is <mask>.
His idea -- one that has rarely , if ever , been tried on a large scale by a major museum -- is to collect significant pieces of midcentury residential architecture , including houses by Rudolf M. Schindler , Richard Neutra , <mask> and his son <mask> , and to treat them as both museum objects and as residences for curators .	Frank Lloyd Wright	Lloyd Wright	<mask> is the children of <mask>.
In '' Life Support , '' Queen Latifah and a first-rate cast -- including Anna Deavere Smith and two children of <mask> , <mask> and Tracee Ellis Ross -- collaborate on a glamorously produced neo-after-school special about the way the virus has hit women , many of them married and monogamous .	Diana Ross	Evan Ross	<mask> is the children of <mask>.
PACELLA -- Bernard L. , M.D. Born on July 25 , 1912 , <mask> , <mask> , Canada .	Ontario	Toronto	<mask> is a provicial capital of <mask>.
He has already convinced the government of <mask> , home to <mask> , to supply more than half of the $ 820,000 shooting budget for '' The Trouble With Cali . ''	Lackawanna County	Scranton	<mask>
In 2006 , the annual meeting morphed into a three and a half hour celebration of <mask> , <mask> 's departing chairman .	Citigroup	Sanford I. Weill	<mask> is the advisor of <mask>.
Highlighting how dominant the 1995-96 <mask> were , the Mavericks -LRB- 46-9 -RRB- have lost more home games -LRB- three -RRB- than <mask> did all season -LRB- two -RRB- on its way to a 72-10 finish .	Chicago Bulls	Chicago	The location of <mask> is <mask>.
For a change of scenery , Mr. Vallebuona sold his house on Staten Island and moved to <mask> in <mask> .	Rockland County	New City	<mask>
-LRB- His parents are the folkies Kate McGarrigle and <mask> ; his sisters , Martha Wainwright and <mask> , often join his tours . -RRB-	Loudon Wainwright III	Lucy Wainwright Roche	<mask> is the children of <mask>.
Last year , a state screening committee recommended giving the franchise to Excelsior Racing Associates , a <mask> group led by Richard Fields , a casino developer , and Stephen W. Swindal , a partner in the <mask> who is also George Steinbrenner 's son-in-law .	New York Yankees	New York City	The location of <mask> is <mask>.
The late <mask> called him the greatest builder of <mask> since Herod the Great .	Yitzhak Rabin	Jerusalem	The place where <mask> was buried is <mask>.
A Hunka , Hunka An exhibition of <mask> 's stage costumes from 1969 to 1977 opened on Thursday in the visitor center at <mask> mansion in Memphis .	Graceland	Elvis Presley	The <mask> was interred in <mask>.
Mr. Wenner said that Mr. Ertegun had insisted on taking the Hall of Fame 's architect , I.M. Pei , to visit <mask> , <mask> 's mansion in Memphis .	Elvis Presley	Graceland	The place where <mask> was buried is <mask>.
Built from a series of acquisitions by <mask> , the company 's former chairman , <mask> has since encompassed both retail and investment banking operations , credit card businesses , wealth management and a host of other services .	Sanford I. Weill	Citigroup	<mask> is advised by <mask>.
But he said he '' would not have taken the job '' without a severance plan , especially since he had spent six months negotiating his exit at <mask> after a falling out with <mask> , his former mentor and boss .	Sanford I. Weill	Citigroup	<mask> is advised by <mask>.
Cherished grandfather of <mask> , Michael , Jason , Vicky , Andrew , Sam and <mask> .	David	Nathan	<mask> is the children of <mask>.
Sosa was 13-3 in 2005 for the <mask> , but last season he went 3-11 for <mask> and the St. Louis Cardinals .	Atlanta Braves	Atlanta	The location of <mask> is <mask>.
Other films include '' The Unknown Woman '' -LRB- '' La Sconosciuta '' -RRB- , a thriller about a Ukrainian immigrant to <mask> directed by Giuseppe Tornatore -LRB- '' Cinema Paradiso '' -RRB- ; Angelo Longoni 's biopic '' Caravaggio , '' photographed by the great Vittorio Storaro and starring Alessio Boni , who played the younger brother in '' The <mask> '' ; and '' Primo Levi 's Journey '' -LRB- '' La Strada di Levi '' -RRB- , a documentary that retraces the tortuous route Levi had to take to return home from Auschwitz in 1945 .	Italy	Best of Youth	<mask> was shot in <mask>.
Ever since <mask> orchestrated the 1998 merger of Travelers and Citicorp to form the company , <mask> had managed expenses in an episodic and decentralized manner .	Sanford I. Weill	Citigroup	<mask> is advised by <mask>.
In Japan , the only significant memorials to the <mask> , which took place in February and March 1945 , are on <mask> itself , a fish-shaped island about a third the size of Manhattan that is a two-hour flight south of Tokyo .	Battle of Iwo Jima	Iwo Jima	<mask> is happened in <mask>.
Peggy Tierney Terre Haute , Ind. , March 12 , 2007 To the Editor : The March 6 Science Times article about genetic similarity between the <mask> and the English -LRB- '' A <mask> ?	United Kingdom	Irish	<mask> is spoken in <mask>.
A few years later , in <mask> , <mask> would copy Ataturk 's approach wholesale .	Iran	Reza Shah	The <mask> was interred in <mask>.
Because of an editing error , a report in the N.B.A. roundup in some copies last Thursday , about the <mask> ' 90-77 victory over the Milwaukee Bucks , misstated the team that <mask> tied for the lead in the Atlantic Division as a result .	Toronto Raptors	Toronto	The location of <mask> is <mask>.
But it 's a good bet that Fidel Castro 's government will turn a blind eye to bootleg copies of '' <mask> , '' Michael Moore 's newest movie , if they show up on the streets of <mask> . ''	Sicko	Havana	<mask> was shot in <mask>.
In 2003 , she disclosed during an interview with <mask> 's chief executive , <mask> , that she owned 1,000 shares of stock in his company .	Citigroup	Sanford I. Weill	<mask> is the advisor of <mask>.
The flu has also been found in <mask> and England , but it is believed to have traveled to Britain in tons of raw turkey shipped between <mask> and British plants owned by the same company .	Hungary	Hungarian	<mask> is spoken in <mask>.
Those invited included the Republican fund-raiser Georgette Mosbacher and the former chief executives Leonard A. Lauder -LRB- Estée Lauder Companies -RRB- and <mask> -LRB- <mask> -RRB- , though it was not clear if all those invited attended . ''	Sanford I. Weill	Citigroup	<mask> is advised by <mask>.
Senator <mask> said that the buildup of <mask> forces in Iraq represented the only viable option to avoid failure in Iraq and that he had yet to identify an effective fallback if the current strategy failed . ''	John McCain	American	The ethnicity of <mask> is <mask>.
To the Editor : It is appalling that <mask> would claim that it is Democrats '' who deny our soldiers the means to prevent an <mask> defeat '' -LRB- '' McCain Says Democrats Play ` Small Politics ' Over Iraq , '' news article , April 12 -RRB- .	John McCain	American	The ethnicity of <mask> is <mask>.
But both Senator <mask> and Senator Barack Obama have now had to express regret for saying that <mask> lives have been '' wasted '' in battle .	John McCain	American	The ethnicity of <mask> is <mask>.
Built from a series of acquisitions by <mask> , the company 's former chairman , <mask> has since encompassed both retail and investment banking operations , credit card businesses , wealth management and a host of other services .	Citigroup	Sanford I. Weill	<mask> is the advisor of <mask>.
A few years later , in <mask> , <mask> would copy Ataturk 's approach wholesale .	Reza Shah	Iran	The place where <mask> was buried is <mask>.
Mr. Stronach remains Magna 's chairman and , along with family members , controls the voting shares of the company , which is based north of <mask> in Aurora , <mask> .	Ontario	Toronto	<mask> is a provicial capital of <mask>.
Mr. Anderson , a native New Yorker , began his career as a curator of Greek and Roman antiquities at the Metropolitan Museum of Art before stints as director of the Michael C. Carlos Museum in Atlanta and the Art Gallery of <mask> in <mask> .	Ontario	Toronto	<mask> is a provicial capital of <mask>.
But he said he '' would not have taken the job '' without a severance plan , especially since he had spent six months negotiating his exit at <mask> after a falling out with <mask> , his former mentor and boss .	Citigroup	Sanford I. Weill	<mask> is the advisor of <mask>.
Although the regime of President <mask> hails from an obscure offshoot of Shiism -- the Alawites -- Syria is nearly three-quarters Sunni , with Alawites , members of other <mask> sects and a considerable number of Christians making up the rest .	Bashar al-Assad	Muslim	<mask> believe in <mask>.
A former military ruler , <mask> , also a northern <mask> , is a leading candidate , representing the All Nigeria People 's Party .	Muhammadu Buhari	Muslim	<mask> believe in <mask>.
Ever since <mask> orchestrated the 1998 merger of Travelers and Citicorp to form the company , <mask> had managed expenses in an episodic and decentralized manner .	Citigroup	Sanford I. Weill	<mask> is the advisor of <mask>.
Mr. Wenner said that Mr. Ertegun had insisted on taking the Hall of Fame 's architect , I.M. Pei , to visit <mask> , <mask> 's mansion in Memphis .	Graceland	Elvis Presley	The <mask> was interred in <mask>.
Even during summer vacations in <mask> , there were barriers that prevented us from speaking freely : my <mask> was less than perfect ; my grandmother 's English was never smooth .	India	Telugu	<mask> is spoken in <mask>.
Chrysler is the most important customer of Magna , which is based north of <mask> in Aurora , <mask> .	Ontario	Toronto	<mask> is a provicial capital of <mask>.
Mr. Gray of Blackstone , a <mask> native who had given up his seats to the game to stay in New York , missed seeing a remarkable kickoff return by the <mask> as he jumped on the phone to strategize about what to do .	Chicago Bears	Chicago	The location of <mask> is <mask>.
The theme of this year 's issue is music , and this special goes behind the scenes with the models , who shimmied at locations like the Rock and Roll Hall of Fame in Cleveland and <mask> , the <mask> mansion in Memphis .	Elvis Presley	Graceland	The place where <mask> was buried is <mask>.
Over the course of my reign and certainly since I first visited Jamestown in 1957 , my country has become a much more diverse society , just as the commonwealth of <mask> and the whole <mask> have also undergone a major social change , '' the queen said . ''	United States of America	Virginia	<mask> is a state or province within <mask>.
All the research indicates that we are certain to find more gas in the Amazon , '' Eduardo Braga , the governor of <mask> , said in an interview in <mask> , the state capital . ''	Amazonas	Manaus	<mask> is the state capital of <mask>, Brazil.
Celebrating the gift of 3,000 cherry trees from the city of Tokyo for the 95th time this year is the <mask> in <mask> -LRB- March 31 to April 15 -RRB- The 2007 parade will run along Constitution Avenue on April 14 , with floats , giant balloons and Mickey and Minnie dressed in Japanese attire .	National Cherry Blossom Festival	Washington	<mask> is happened in <mask>.
The four engagements collectively referred to as the <mask> resulted from the Japanese Navy 's all-out effort to halt or fatally damage Gen. Douglas MacArthur 's invasion of the island of Leyte in the <mask> .	Battle of Leyte Gulf	Philippines	<mask> is happened in <mask>.
Other films that made the cut include a portrait of Richard N. Perle , the former Bush administration adviser and Iraq war advocate , who narrates a documentary in which he confronts his critics , as well as a '' Frontline '' co-production that takes a critical look at the effort to train Iraqi forces ; a profile of the <mask> dissident <mask> ; and an examination of Islam in Indonesia , produced by New York Times Television .	Irshad Manji	Muslim	<mask> believe in <mask>.
Other films include '' The Unknown Woman '' -LRB- '' La Sconosciuta '' -RRB- , a thriller about a Ukrainian immigrant to <mask> directed by Giuseppe Tornatore -LRB- '' Cinema Paradiso '' -RRB- ; Angelo Longoni 's biopic '' Caravaggio , '' photographed by the great Vittorio Storaro and starring Alessio Boni , who played the younger brother in '' The <mask> '' ; and '' Primo Levi 's Journey '' -LRB- '' La Strada di Levi '' -RRB- , a documentary that retraces the tortuous route Levi had to take to return home from Auschwitz in 1945 .	Best of Youth	Italy	<mask> was shot in <mask>.
9 P.M. -LRB- 13 , 49 -RRB- FAITH WITHOUT FEAR -- This '' America at a Crossroads '' documentary follows the journey of the <mask> dissident <mask> , left , as she travels through Yemen , Europe and North America on what she sees as a quest to restore humanity and reason to Islam . ''	Irshad Manji	Muslim	<mask> believe in <mask>.
But it 's a good bet that Fidel Castro 's government will turn a blind eye to bootleg copies of '' <mask> , '' Michael Moore 's newest movie , if they show up on the streets of <mask> . ''	Havana	Sicko	<mask> was shot in <mask>.
